{
  "name": "Keychron Q0",
  "vendorProductId": 875823408,
  "macros": ["", "", "", "", "", "", "", "", "", "", "", "", "", "", "", ""],
  "layers": [
    [
      "MO(1)",
      "KC_LALT",
      "KC_ENT",
      "KC_BSPC",
      "KC_NLCK",
      "KC_PSLS",
      "KC_PAST",
      "KC_PMNS",
      "KC_P7",
      "KC_P8",
      "KC_P9",
      "KC_PPLS",
      "KC_P4",
      "KC_P5",
      "KC_P6",
      "KC_NO",
      "KC_P1",
      "KC_P2",
      "KC_P3",
      "KC_PENT",
      "KC_P0",
      "KC_NO",
      "KC_PDOT",
      "KC_NO"
    ],
    [
      "KC_TRNS",
      "KC_MUTE",
      "KC_VOLD",
      "KC_VOLU",
      "RGB_MOD",
      "RGB_VAI",
      "RGB_HUI",
      "KC_DEL",
      "RGB_RMOD",
      "RGB_VAD",
      "RGB_HUD",
      "KC_TRNS",
      "RGB_SAI",
      "RGB_SPI",
      "KC_MPRV",
      "KC_NO",
      "RGB_SAD",
      "RGB_SPD",
      "KC_MPLY",
      "RESET",
      "RGB_TOG",
      "KC_NO",
      "KC_MNXT",
      "KC_NO"
    ],
    [
      "KC_TRNS",
      "KC_TRNS",
      "KC_TRNS",
      "KC_TRNS",
      "KC_TRNS",
      "KC_TRNS",
      "KC_TRNS",
      "KC_TRNS",
      "KC_TRNS",
      "KC_TRNS",
      "KC_TRNS",
      "KC_TRNS",
      "KC_TRNS",
      "KC_TRNS",
      "KC_TRNS",
      "KC_NO",
      "KC_TRNS",
      "KC_TRNS",
      "KC_TRNS",
      "KC_TRNS",
      "KC_TRNS",
      "KC_NO",
      "KC_TRNS",
      "KC_NO"
    ],
    [
      "KC_TRNS",
      "KC_TRNS",
      "KC_TRNS",
      "KC_TRNS",
      "KC_TRNS",
      "KC_TRNS",
      "KC_TRNS",
      "KC_TRNS",
      "KC_TRNS",
      "KC_TRNS",
      "KC_TRNS",
      "KC_TRNS",
      "KC_TRNS",
      "KC_TRNS",
      "KC_TRNS",
      "KC_NO",
      "KC_TRNS",
      "KC_TRNS",
      "KC_TRNS",
      "KC_TRNS",
      "KC_TRNS",
      "KC_NO",
      "KC_TRNS",
      "KC_NO"
    ]
  ],
  "encoders": []
}